NO textures/golden.xpm
SO textures/olivee.xpm
WE textures/burgundy.xpm
EA textures/baroque.xpm
F 66,40,29
C 245,240,220

111111111111111111111
10000000000000000N001
111111111111111111111